11111111111
100011001e1
10001010101
10001110101
10000m00001
11111111111
