1111111111
1m10000001
1001111101
1000000101
1011111101
1000000101
1001111101
100000000e
1111111111
