11111111111111111111111111111111111111111
1110000001000100000100011e000001000010001
10110100010100001001000111111101010010101
10100101110100001001000111111101010010101
10101100100100001000000000001101010010101
10100110100101101011000001000001010010101
10110100101000101011000001001101010010101
10100101101000100011000001001100010010101
10101100101000100011110001001100110010101
10000110001100100000000001001100010000101
11111111111111111111111111111111111111111