a
1111111111
1m10000001
1001111101
1000000101
1011111101
1000000101
1001111101
100000000e
1111111111
b
11111111111111111111111111111111111111111
1m10000001000100000100011e000001000010001
10110100010100001001000111111101010010101
10100101110100001001000111111101010010101
10101100100100001000000000001101010010101
10100110100101101011000001000001010010101
10110100101000101011000001001101010010101
10100101101000100011000001001100010010101
10101100101000100011110001001100110010101
10000110001100100000000001001100010000101
11111111111111111111111111111111111111111
c
111m1111111
10000010001
11101110101
10000000101
11101111101
10000000001
111111111e1
d
11111111111111111
10000000m00000001
11111111011111111
10000000000000001
11111111011111111
10000000000000001
11111111011111111
10000000000000001
11111111011111111
10000000000000001
11111111011111111
10000000000000001
11111111011111111
10000000000000001
11111111011111111
11111111e11111111
e
1111
10m1
1011
1e11